Team Manager - 
            1) addemployee component              --  adding new employee
            2) addproject  component              --  adding new project
            3) addtask component                  --  adding new task for selected project   
            4) assignedtaskbymanager component    --  showing assigned task list
            5) assignthetask  component           --  showing unassigned task and giving ti assign for any employee 
            6) employeelist component             --  fetching emplyee list from db
            7) filteredtasks component            --  task filteration like today yesterday weakly monthly yearly
            8) getallocatedtaskoverview           --  tasks statuswise count 
            9) managerprojects                   --  for gating project of whose managr is loged in
            10) projectcompletion                 --  project completion progress barr
            11) projectsstatuscount               --  task statuswise count of each project
            12) projectworkbyteammembers          --  total working houres of each employee on each project
            13) tasksbymanager                    --  parent component for ussigned and unassigned tasks
            14) teammanagerdashboard              --  dashbord for when manager was loged in thate time some data will shown on dashboaerd
            15) timesheetlist                     --  for fetching team managers assigned employees timesheet
            16) totalprojectworkhours             --  for calculating total work dooing by teammembers on this projects
            17) nassignedtasksbymanager          --  for getting unussigned tasks
            18) pdateproject                     --  for get access to update any details of previous projects
            19) atetask                        --  for geting access to update any details of previous tasks
            20 updatetasksstatus                 --  for updating status of task when any emplyee get complete therin tasks or not
            21 unassignedtasks                   -- unassigned task of selected project


Team Member - 
            1) addtimesheet                       --  adding new time sheet
            2) alltaskslist                       --  for showing all tasklist
            3) dashboard                          --  dashbord for teammember
            4) employeedetails                    --  for showing employee details
            5) employeeprojectdetails             --  for getting project details
            6) employeeprojectfilters             --  project filteration like today yesterday weakly monthly yearly
            7) employeeproject                    --  for getting employees project whose employee loged in
            8) filteredtasks                      -- tasks  filteration like today yesterday weakly monthly yearly
            9) projecttemmembers                  -- for finding teammembers on any project
            10) taskdetails                       -- for finding details of any tasks
            11) taskdetailsinfo                   -- for finding total detains of task
            12) taskslist                         -- for finding only loged in employees tasks
            13) tasksofprojects                   -- for only selected projects tasks finding
            14) timesheetdetails                  -- finding timsheets details
            15) timesheetlist                     -- finding all timesheet list of which employee loged in  
            16) updatetimesheet                   -- for updating any timesheet